12 12 12 12 12 12 12 12 12 12 12 12 12 12 12 12 12 12 12 12 12 12 12 12 12 12 12 12 12 12 12 12 12 12 12 12 12 12 12 12 12 12 12 12 12 12 12 12 12 12 12 12 12 12 12 12 12 12 12 12 12 
12 12 12 12 12 12 12 12 12 12 12 12 12 12 12 12 12 12 12 12 12 12 12 12 12 12 12 12 12 12 12 12 12 12 12 12 12 12 12 12 12 12 12 12 12 12 12 12 12 12 12 12 12 12 12 12 12 12 12 12 12 
12 12 12 12 12 12 12 12 12 12 12 12 12 12 12 12 12 12 12 12 12 12 12 12 12 12 12 12 12 12 12 12 12 12 12 12 12 12 12 12 12 12 12 12 12 12 12 12 12 12 12 12 12 12 12 12 12 12 12 12 12 
12 12 12 12 12 12 12 12 12 12 12 12 12 12 12 12 12 12 12 12 12 12 12 12 12 12 12 12 12 12 12 12 12 12 12 12 12 12 12 12 12 12 12 12 12 12 12 12 12 12 12 12 12 12 12 12 12 12 12 12 12 
12 12 12 12 12 12 12 12 12 12 12 12 12 12 12 12 12 12 12 12 12 12 12 12 12 12 12 13 12 12 12 12 12 12 12 13 12 12 12 12 12 12 12 12 12 12 12 12 12 12 12 12 12 12 12 12 12 12 12 12 12  
12 12 12 12 12 12 12 12 12 12 12 12 12 12 12 12 12 12 12 12 12 12 12 12 12 12 12 12 12 12 12 12 12 12 12 12 12 12 12 12 12 12 12 12 12 12 12 12 12 12 12 12 12 12 12 12 12 12 12 12 12  
12 12 12 12 12 12 12 22 20 20 20 20 20 20 20 20 20 20 20 23 12 12 12 12 12 22 20 20 20 20 20 20 20 20 20 20 20 20 20 20 20 20 20 20 20 20 20 20 20 20 20 20 20 23 12 12 12 12 12 12 12 
12 12 12 12 12 12 12 18 42 66 67 42 66 67 42 66 67 41 42 17 22 20 20 20 20 21 41 41 41 41 42 41 41 41 41 41 41 41 41 41 41 41 74 41 11 11 11 46 47 48 49 11 11 17 12 12 12 12 12 12 12 
12 12 12 12 12 12 12 18 11 68 69 11 68 69 11 68 69 11 11 17 18 41 41 46 47 48 49 35 33 33 33 33 33 33 33 41 41 41 74 41 41 41 41 41 11 11 11 50 51 52 53 11 11 17 12 12 12 12 12 12 12 
12 12 12 12 12 12 12 18 11 70 71 11 70 71 11 70 71 11 14 25 18 41 41 50 51 52 53 31 26 26 26 26 26 26 26 44 44 44 44 44 44 44 41 41 11 11 11 54 55 56 57 11 11 17 12 12 12 12 12 12 12 
12 12 12 12 12 12 12 18 11 72 73 11 72 73 11 72 73 11 17 22 21 41 74 54 55 56 57 31 26 27 28 28 28 28 28 46 47 48 49 41 41 11 11 11 11 11 11 58 59 60 61 11 41 17 12 12 12 12 12 12 12 
12 12 12 12 12 12 12 18 39 39 39 39 39 39 39 39 39 39 17 18 41 41 41 58 59 60 61 31 26 30 41 41 41 41 41 50 51 52 53 41 41 11 11 11 11 11 11 62 63 64 65 11 41 17 12 12 12 12 12 12 12 
12 12 12 12 12 12 12 18 41 41 41 29 26 27 41 74 41 41 17 18 41 41 41 62 63 64 65 31 26 30 41 74 41 41 41 54 55 56 57 41 41 11 11 42 11 11 14 15 15 15 16 11 41 17 12 12 12 12 12 12 12 
12 12 12 12 12 12 12 18 41 74 35 34 26 32 33 33 33 33 19 21 33 33 33 33 33 33 33 34 26 30 41 41 41 41 41 58 59 60 61 41 41 11 11 11 11 14 25 12 12 12 18 11 41 17 12 12 12 12 12 12 12 
12 12 12 12 12 12 12 18 41 41 31 26 26 26 26 26 26 26 26 26 26 26 26 26 26 26 26 26 26 30 41 41 41 41 41 62 63 64 65 41 41 11 11 11 14 25 12 12 12 12 18 11 41 17 12 12 12 12 12 12 12 
12 12 12 12 12 12 12 18 41 41 37 29 26 27 28 28 28 28 14 16 28 28 28 28 28 28 28 29 26 30 46 47 48 49 41 74 41 41 41 41 11 11 11 11 17 12 12 12 12 22 21 11 41 17 12 12 12 12 12 12 12 
12 12 12 12 12 12 12 18 41 41 41 31 26 30 74 41 41 41 17 18 41 74 41 41 41 41 74 31 26 30 50 51 52 53 41 41 41 41 41 41 11 42 11 11 19 20 23 12 12 18 11 11 41 17 12 12 12 12 12 12 12 
12 12 12 12 12 12 12 24 15 15 15 16 26 14 15 15 15 15 25 18 74 41 41 41 74 41 41 31 26 30 54 55 56 57 41 41 41 41 41 41 11 11 11 11 11 11 19 20 23 24 16 11 41 17 12 12 12 12 12 12 12 
12 12 12 12 12 12 12 22 20 20 20 21 26 19 20 20 20 20 20 21 41 74 41 41 41 41 41 31 26 30 58 59 60 61 41 41 41 41 74 41 41 41 41 41 11 11 11 11 19 23 18 11 41 17 12 12 12 12 12 12 12 
12 12 12 12 12 12 12 18 41 74 41 31 26 30 41 74 41 41 42 41 41 41 41 41 41 74 41 31 26 30 62 63 64 65 41 41 41 74 41 41 41 41 41 41 11 11 11 11 11 19 21 11 41 17 12 12 12 12 12 12 12 
12 12 12 12 12 12 12 18 41 41 41 31 26 32 33 33 33 33 33 33 33 33 33 33 33 33 33 34 26 32 33 33 33 33 33 33 33 33 33 33 33 33 33 36 11 11 11 11 11 11 11 11 41 17 12 12 12 12 12 12 12 
12 12 12 12 12 12 12 18 41 41 41 31 26 26 26 26 26 26 26 26 26 26 26 26 26 26 26 26 26 26 26 26 26 26 26 26 26 26 26 26 26 26 26 30 46 47 48 49 74 41 41 41 41 17 12 12 12 12 12 12 12 
12 12 12 12 12 12 12 18 41 41 41 37 28 28 28 28 28 28 28 28 28 28 28 28 28 28 28 29 26 27 28 28 28 28 28 28 28 28 28 28 28 29 26 30 50 51 52 53 41 41 41 41 41 17 12 12 12 12 12 12 12                                                                     
12 12 12 12 12 12 12 18 41 74 41 41 41 41 41 74 41 41 41 41 41 41 41 74 41 41 41 31 26 30 41 74 41 41 41 74 41 41 41 74 41 31 26 30 54 55 56 57 41 41 41 74 41 17 12 12 12 12 12 12 12 
12 12 12 12 12 12 12 18 41 74 41 41 41 74 41 41 41 74 41 41 41 41 41 41 41 41 41 31 26 30 41 41 41 41 74 41 41 41 41 41 41 31 26 30 58 59 60 61 39 39 39 39 41 17 12 12 12 12 12 12 12 
12 12 12 12 12 12 12 18 41 41 14 15 15 15 15 15 15 15 15 15 15 15 15 15 16 41 41 40 26 40 41 74 41 41 41 41 41 74 41 41 41 40 26 40 62 63 64 65 41 74 41 39 41 17 12 12 12 12 12 12 12 
12 12 12 12 12 12 12 18 41 41 17 12 12 12 12 12 12 12 12 12 12 12 12 12 18 41 41 11 11 11 41 39 39 39 39 39 39 39 39 39 39 39 39 41 41 41 74 41 41 41 41 39 41 17 12 12 12 12 12 12 12 
12 12 12 12 12 12 12 18 41 41 17 12 12 12 12 12 12 12 12 12 12 12 12 12 18 41 41 11 11 11 41 39 41 41 41 41 41 41 41 74 41 41 41 74 41 41 39 39 39 39 39 39 41 17 12 12 12 12 12 12 12 
12 12 12 12 12 12 12 18 41 41 17 12 22 20 20 20 20 20 20 20 20 20 23 12 18 41 41 11 11 11 41 39 41 74 41 41 41 41 41 41 41 41 74 41 41 41 39 46 47 48 49 41 41 17 12 12 12 12 12 12 12 
12 12 12 12 12 12 12 18 41 41 17 12 18 40 40 40 40 40 40 40 40 40 17 12 18 41 41 11 11 11 41 39 41 41 41 41 74 41 41 41 74 41 41 41 41 41 39 50 51 52 53 41 74 17 12 12 12 12 12 12 12 
12 12 12 12 12 12 12 18 41 41 17 12 18 40 45 45 45 45 45 45 45 40 17 12 18 41 41 11 11 11 41 39 41 41 41 39 39 39 39 39 39 39 39 39 39 39 39 54 55 56 57 74 41 17 12 12 12 12 12 12 12 
12 12 12 12 12 12 12 18 41 41 17 12 18 40 45 43 43 43 43 43 45 40 17 12 18 41 41 39 41 41 41 39 41 41 41 39 41 41 74 41 41 39 41 41 41 41 41 58 59 60 61 41 41 17 12 12 12 12 12 12 12 
12 12 12 12 12 12 12 18 41 41 17 12 18 40 45 43 43 11 43 43 45 40 17 12 18 41 41 39 39 39 41 39 39 39 39 39 74 41 41 41 74 39 41 74 74 41 41 62 63 64 65 41 41 17 12 12 12 12 12 12 12 
12 12 12 12 12 12 12 18 41 41 17 12 18 40 45 43 43 43 43 43 45 40 17 12 18 41 41 41 41 39 74 41 74 41 41 39 41 41 74 41 41 39 41 41 41 41 41 74 41 41 41 74 41 17 12 12 12 12 12 12 12 
12 12 12 12 12 12 12 18 41 41 17 12 18 40 45 43 43 43 43 43 45 40 17 12 18 41 41 39 39 39 41 41 41 41 74 41 74 41 41 41 39 39 39 39 39 39 39 39 39 39 39 39 41 17 12 12 12 12 12 12 12 
12 12 12 12 12 12 12 18 41 41 17 12 18 40 40 40 40 43 40 40 40 40 17 12 18 41 41 39 41 41 41 41 41 74 41 41 41 39 39 39 39 74 41 74 41 41 74 41 41 74 41 39 41 17 12 12 12 12 12 12 12 
12 12 12 12 12 12 12 18 41 41 17 12 24 15 15 15 16 11 14 15 15 15 25 12 18 41 41 39 39 39 41 39 39 39 39 41 74 39 41 41 41 41 41 41 41 41 41 41 41 41 41 39 74 17 12 12 12 12 12 12 12 
12 12 12 12 12 12 12 18 41 41 17 12 12 12 12 12 18 11 17 12 12 12 12 12 18 41 41 41 41 39 41 39 41 41 39 41 41 39 74 74 41 41 41 41 39 39 39 39 39 39 41 39 41 17 12 12 12 12 12 12 12 
12 12 12 12 12 12 12 18 41 41 17 12 12 12 12 12 18 11 17 12 12 12 12 12 18 41 41 39 39 39 41 41 41 41 39 39 39 39 39 39 41 41 41 39 39 74 41 41 41 39 41 39 41 17 12 12 12 12 12 12 12 
12 12 12 12 12 12 12 18 41 41 17 12 12 22 20 20 21 11 19 20 20 23 12 12 18 41 41 39 41 41 41 74 41 41 39 74 41 41 41 39 39 41 41 39 41 41 41 74 41 39 41 39 74 17 12 12 12 12 12 12 12 
12 12 12 12 12 12 12 18 41 41 17 12 12 18 42 11 11 11 11 11 42 17 12 12 18 41 41 39 39 39 41 41 41 41 39 41 41 41 41 41 39 41 41 39 41 41 41 41 39 39 41 39 41 17 12 12 12 12 12 12 12 
12 12 12 12 12 12 12 18 41 41 17 12 12 24 15 16 11 11 11 14 15 25 12 12 18 41 41 41 41 39 74 41 39 39 39 39 39 39 39 41 39 41 41 39 39 39 39 41 39 41 41 39 41 17 12 12 12 12 12 12 12 
12 12 12 12 12 12 12 18 41 41 17 12 12 12 12 18 11 11 11 17 12 12 12 12 18 41 41 41 39 39 41 41 39 41 41 41 41 41 39 41 41 41 41 41 41 41 74 74 39 41 41 39 41 17 12 12 12 12 12 12 12 
12 12 12 12 12 12 12 18 41 41 17 12 12 12 12 18 11 11 11 17 12 12 12 12 18 41 41 41 39 41 41 74 39 41 74 41 41 41 39 41 39 74 41 41 41 41 41 41 39 41 41 39 41 17 12 12 12 12 12 12 12 
12 12 12 12 12 12 12 18 41 41 17 12 12 12 12 18 11 11 11 17 12 12 12 12 18 41 41 11 11 11 41 41 39 41 41 41 41 41 39 39 39 41 39 39 39 39 39 39 39 74 41 41 41 17 12 12 12 12 12 12 12 
12 12 12 12 12 12 12 18 41 41 17 12 12 12 12 18 11 11 11 17 12 12 12 12 18 41 41 11 11 11 41 41 39 39 39 39 41 41 41 41 41 41 39 41 41 41 41 41 39 41 41 41 41 17 12 12 12 12 12 12 12 
12 12 12 12 12 12 12 18 41 41 17 12 12 12 12 18 11 11 11 17 12 12 12 12 18 41 41 11 11 11 41 41 41 41 41 39 39 39 39 39 39 39 39 41 41 74 41 41 39 39 41 41 41 17 12 12 12 12 12 12 12 
12 12 12 12 12 12 12 18 41 41 19 20 20 20 20 21 11 11 11 17 12 12 12 12 18 41 41 11 11 11 41 41 74 41 41 41 41 41 41 41 39 41 41 41 74 41 41 41 41 41 41 41 41 17 12 12 12 12 12 12 12 
12 12 12 12 12 12 12 18 41 41 41 74 41 41 41 41 40 11 40 41 41 41 74 41 41 41 41 41 41 41 41 41 41 41 41 41 74 41 41 41 39 41 41 41 41 41 41 74 41 41 74 41 41 17 12 12 12 12 12 12 12 
12 12 12 12 12 12 12 18 41 11 11 11 11 11 11 11 31 26 30 41 41 74 41 41 41 41 41 41 41 41 41 41 41 74 41 41 41 41 41 31 26 30 11 11 11 11 11 11 11 11 11 11 11 17 12 12 12 12 12 12 12                                            
12 12 12 12 12 12 12 18 74 11 11 11 11 11 11 11 31 26 30 41 41 41 41 41 41 74 41 41 41 41 41 74 41 41 41 41 74 41 41 31 26 30 14 15 15 15 15 15 15 15 15 15 15 25 12 12 12 12 12 12 12  
12 12 12 12 12 12 12 24 15 15 15 15 15 15 15 16 31 26 32 33 33 33 33 33 33 33 40 33 33 33 33 33 33 33 33 33 33 33 33 34 26 30 17 12 12 12 12 12 12 12 12 12 12 12 12 12 12 12 12 12 12 
12 12 12 12 12 12 12 12 12 12 12 12 12 12 12 18 31 26 26 26 26 26 26 26 26 26 26 26 26 26 26 26 26 26 26 26 26 26 26 26 26 30 17 12 12 12 12 12 12 12 12 12 12 12 12 12 12 12 12 12 12 
12 12 12 12 12 12 12 12 12 12 12 12 12 12 12 18 37 28 28 28 28 28 28 28 28 28 40 28 28 28 28 28 28 28 28 28 28 28 28 28 28 38 17 12 12 12 12 12 12 12 12 12 12 12 12 12 12 12 12 12 12 
12 12 12 12 12 12 12 12 12 12 12 12 12 12 12 24 15 15 15 15 15 15 15 15 15 15 15 15 15 15 15 15 15 15 15 15 15 15 15 15 15 15 25 12 12 12 12 12 12 12 12 12 12 12 12 12 12 12 12 12 12 
12 12 12 12 12 12 12 12 12 12 12 12 12 12 12 12 12 12 12 12 12 12 12 12 12 12 12 12 12 12 12 12 12 12 12 12 12 12 12 12 12 12 12 12 12 12 12 12 12 12 12 12 12 12 12 12 12 12 12 12 12 
12 12 12 12 12 12 12 12 12 12 12 12 12 12 12 12 12 12 12 12 12 12 12 12 12 12 12 12 12 12 12 12 12 12 12 12 12 12 12 12 12 12 12 12 12 12 12 12 12 12 12 12 12 12 12 12 12 12 12 12 12 
12 12 12 12 12 12 12 12 12 12 12 12 12 12 12 12 12 12 12 12 12 12 12 12 12 12 12 12 12 12 12 12 12 12 12 12 12 12 12 12 12 12 12 12 12 12 12 12 12 12 12 12 12 12 12 12 12 12 12 12 12 
12 12 12 12 12 12 12 12 12 12 12 12 12 12 12 12 12 12 12 12 12 12 12 12 12 12 12 12 12 12 12 12 12 12 12 12 12 12 12 12 12 12 12 12 12 12 12 12 12 12 12 12 12 12 12 12 12 12 12 12 12 
12 12 12 12 12 12 12 12 12 12 12 12 12 12 12 12 12 12 12 12 12 12 12 12 12 12 12 12 12 12 12 12 12 12 12 12 12 12 12 12 12 12 12 12 12 12 12 12 12 12 12 12 12 12 12 12 12 12 12 12 12 
12 12 12 12 12 12 12 12 12 12 12 12 12 12 12 12 12 12 12 12 12 12 12 12 12 12 12 12 12 12 12 12 12 12 12 12 12 12 12 12 12 12 12 12 12 12 12 12 12 12 12 12 12 12 12 12 12 12 12 12 12 
